[In Artemisia]:
蒿里行		# Aka "Through the Wormwood" aka "The Graveyard Song" aka Total War Cao Cao Theme
xaw liX hang/haeng/haengH	# Middle Chinese reading.
kau li hang/häng 	# North Finnic reading.
kau li hang/häng	# Finnish reading, early borrowing.
kau li hang/häng	# Finnish reading, late borrowing.

关东有义士，兴兵讨群凶
kwaen tuwng hjuwX ngjeH dzriX  xing pjaeng thawX gjun xjowng	# Middle Chinese reading.
kän tuung juu ne ci  king päng tau kiun koung 	# North Finnic reading.
kän tuung juu ne si  king päng tau kiun koung	# Finnish reading, early borrowing.
kyän tuung hiu nie tsi  king piäng tau kiun kiong	# Finnish reading, late borrowing.

初期会孟津，乃心在咸阳
tsrhjo gi hwajH/kwajH maengH tsin  nojX sim dzojX heam yang	# Middle Chinese reading.
co ki vai/kai mäng cin  noi sim coi häm jang 	# North Finnic reading.
so ki vai/kai mäng sin  noi sim soi häm jang	# Finnish reading, early borrowing.
tsio ki hua/kua mäng tsin  noi sim tsoi häm jang	# Finnish reading, late borrowing.

军合力不齐，踌躇而雁行
kjun kop/hop lik pjuw dzej  drjuw trhjak nyi ngaenH hang/haeng/haengH	# Middle Chinese reading.
kiun kop/hop lik piu cei  tiu tak nii nän hang/häng 	# North Finnic reading.
kiun kop/hop lik piu sei  tiu tak nii nän hang/häng	# Finnish reading, early borrowing.
kiun kop/hop lik piu tsei  tiu tiak ni nän hang/häng	# Finnish reading, late borrowing.

势利使人争，嗣还自相戕
syejH lijH sriX/sriH nyin tsreang  ziH hwaen/zjwen dzijH sjang/sjangH ka/dzjang/tsang	# Middle Chinese reading.
sei lii si nin cäng  si vän/sen cii sang ka/cang 	# North Finnic reading.
sei lii si nin säng  si vän/sen sii sang ka/sang	# Finnish reading, early borrowing.
sie lii si nin tsäng  si hyän/suen tsii siang ka/tsiang/tsang	# Finnish reading, late borrowing.

淮南弟称号，刻玺于北方
hweaj nom dejX tsyhing/tsyhingH hawH  khok sjeX hju pok pjang	# Middle Chinese reading.
väi nom tei king hau  kok se ju pok pang 	# North Finnic reading.
väi nom tei king hau  kok se ju pok pang	# Finnish reading, early borrowing.
hyä nom tei king hau  kok sie hiu pok piang	# Finnish reading, late borrowing.

铠甲生虮虱，万姓以死亡
khojX/khojH kaep sraeng/srjaeng kij srit  mjwonH/mok sjengH yiX sijX mjang	# Middle Chinese reading.
koi käp säng kii sit  mon/mok seng ji sii mang 	# North Finnic reading.
koi käp säng kii sit  mon/mok seng ji sii mang	# Finnish reading, early borrowing.
koi käp säng/siäng kii sit  muon/mok sieng ji sii miang	# Finnish reading, late borrowing.

白骨露于野，千里无鸡鸣
baek kwot luH hju yaeX  tshen liX mju kej mjaeng	# Middle Chinese reading.
päk kot lu ju jä  cen li miu kei mäng 	# North Finnic reading.
päk kot lu ju jä  sen li miu kei mäng	# Finnish reading, early borrowing.
päk kuot lu hiu jä  tsen li miu kei miäng	# Finnish reading, late borrowing.

生民百遗一，念之断人肠
sraeng/srjaeng mjin paek ywijH 'jit  nemH tsyi dwanX/twanX/twanH nyin drjang	# Middle Chinese reading.
säng min päk jui jit  nem ki tan nin tang 	# North Finnic reading.
säng min päk jui jit  nem ki tan nin tang	# Finnish reading, early borrowing.
säng/siäng miin päk jui jit  nem ki tuan nin tiang	# Finnish reading, late borrowing.

